2 0 0 0 1 0 0 0 3 1 0 0 0
0 1 6 1 3 1 0 1 0 1 0 1 0
3 0 0 0 3 3 0 0 3 3 0 0 0
0 1 0 1 0 1 0 1 0 1 4 1 3
1 0 3 0 0 0 3 0 3 3 0 0 0
0 1 0 1 3 1 0 1 3 1 3 1 0
0 0 3 3 3 0 1 0 3 0 0 0 3
3 1 3 1 0 1 0 1 1 1 3 1 3
0 0 1 0 4 0 0 3 3 0 4 0 0
3 1 1 1 0 1 0 1 0 1 0 1 0
0 3 0 0 1 0 3 0 0 3 3 3 3


0 = green title
1 = obstacle
2 = player
3 = alarm
4 = flyhead
5 = BrightHead
6 = tunnel to next level