2 0 3 0 1 0 4 0 6 1 0 0 0
0 1 0 1 3 1 0 1 0 1 0 1 0
0 1 0 0 3 3 0 0 3 3 0 0 3
0 1 0 1 4 1 0 1 0 1 0 1 3
0 0 0 3 0 0 3 0 3 3 0 0 0
3 1 3 1 3 1 0 1 3 1 3 1 0
0 0 0 0 3 0 1 0 3 0 0 0 3
1 1 0 1 0 1 0 1 1 1 3 1 3
1 3 3 0 5 0 0 3 3 0 0 0 0
4 1 0 1 0 1 0 1 0 1 0 1 0
0 3 0 3 1 0 3 0 4 3 3 3 3